product_id,sentiment_value,1,2,3,4,5,total_ratings,score
7084440917,0.7768526228143214,218,155,523,1432,3677,6005,0.7768526228143214
5033369736,0.9074,125,44,287,1008,3536,5000,0.7554864567716142
4749287511,0.9520652728199898,29,8,57,303,1564,1961,0.31069396459342996
2707980656,0.9099549774887443,55,18,118,426,1382,1999,0.3027119923446647
2492731906,0.9014507253626813,20,18,98,363,1500,1999,0.2998829083040604
2266238579,0.8544152744630071,93,42,144,470,1346,2095,0.29789957845261933
1523990920,0.8772365805168986,41,36,145,496,1294,2012,0.29372739077777216
4961087206,0.8479239619809905,85,21,124,500,1269,1999,0.28207632051908016
8749250817,0.8204740292486132,123,41,116,405,1298,1983,0.2707577964253711
1110142968,0.7888167748377434,107,34,133,504,1225,2003,0.2629389249459144
2987355840,0.8261344997266266,78,25,91,377,1258,1829,0.25143223904723416
2035203725,0.8662420382165605,51,21,81,385,1189,1727,0.248920125924299
5259290119,0.7313060817547358,172,45,116,427,1246,2006,0.24413416422396975
9896799911,0.8112994350282486,66,49,175,445,1035,1770,0.2389434284740869
1298361087,0.6426303854875284,204,60,156,562,1223,2205,0.23583453926853656
0152793086,0.7782122905027933,105,47,182,410,1046,1790,0.23179136688638918
3970848949,0.7521367521367521,127,37,110,471,1010,1755,0.21963946801528011
6930057074,0.8022457891453525,75,24,101,375,1028,1603,0.2139589386009844
7572937300,0.8262273901808785,44,9,104,348,1043,1548,0.21278486510405437
9134020477,0.608304152076038,226,89,171,459,1054,1999,0.202362717257346
3276934565,0.6455624646693047,151,77,220,458,863,1769,0.19002313427797124
5790598290,0.5886109632783395,263,80,169,461,906,1879,0.18404510712534453
9235265066,0.8025241276911655,51,48,145,368,735,1347,0.17980925399710437
5629545781,0.6679035250463822,212,38,138,307,922,1617,0.1796875217307858
2527900369,0.6820480404551201,150,53,136,364,879,1582,0.17951622587357816
6700355190,0.7217453505007153,107,54,144,293,800,1398,0.1678421638012658
2932444969,0.9231473010064044,22,14,45,256,756,1093,0.16777506336798056
9589393069,0.6034897713598074,221,64,118,298,961,1662,0.16688206237835757
2084753020,0.7690513219284604,60,62,127,326,711,1286,0.16449473552492805
0511644414,0.8158333333333333,56,11,51,234,848,1200,0.16281331556444
3254842450,0.5410654827968924,210,68,122,350,1052,1802,0.16223852557627957
3375849634,0.461,397,111,233,341,918,2000,0.15343628185907046
4208873058,0.8714555765595463,21,7,50,204,776,1058,0.15329953170862584
9926591370,0.8820709491850431,26,10,28,141,838,1043,0.15296282826947025
5977404441,0.841796875,25,21,95,239,644,1024,0.1433144105030818
9174837032,0.9288888888888889,15,6,52,204,623,900,0.13895422659040849
8570415113,0.5411997363216875,214,90,201,305,707,1517,0.13658464110067575
2677946358,0.7316636851520573,81,33,143,289,572,1118,0.13602143472092218
0222860349,0.652315190901706,130,35,77,224,765,1231,0.13354912037617803
6300874711,0.8101135190918473,68,16,71,199,615,969,0.13049804647040086
2245555107,0.6483516483516484,106,50,114,290,623,1183,0.12755343939751734
9552862048,0.7858672376873662,64,16,49,204,601,934,0.12201037240123692
4511904328,0.900990099009901,14,15,58,145,576,808,0.12097251704180913
3550465393,0.6609090909090909,111,45,127,220,597,1100,0.12088592067602563
5617975490,0.6498194945848376,117,44,100,267,580,1108,0.1197235317359371
8773262738,0.8216867469879519,31,34,86,209,470,830,0.11333610303282095
6357552884,0.8896276595744681,14,5,11,72,650,752,0.11114788350505599
8192873350,0.6632653061224489,110,28,55,239,548,980,0.10805821579006415
2106369652,0.6627282491944146,85,28,93,209,516,931,0.10256114334526258
6151039242,0.3593099345627603,400,92,204,245,740,1681,0.10049664836429693
9904452243,0.8637015781922525,27,3,34,162,471,697,0.09999543508972437
2183863932,0.658157602663707,94,39,90,210,468,901,0.09856466513321216
4808802727,0.7128205128205128,70,24,67,198,421,780,0.09238286839486239
6671996304,0.6095132743362832,105,31,79,194,495,904,0.09158437005685947
7467384544,0.6791979949874687,75,19,58,146,500,798,0.09006190305014578
0689103580,0.8092307692307692,30,17,53,145,405,650,0.08735324645369623
7268963423,0.7507246376811594,59,21,55,106,449,690,0.08604007175156382
9143049498,0.8684654300168634,10,4,70,126,383,593,0.08550109430950628
8025649028,0.8533333333333334,18,8,50,136,388,600,0.08500638569604087
3522867501,0.7905844155844156,35,13,33,136,399,616,0.08086270717455125
1016568590,0.7256371814092953,37,18,44,165,403,667,0.08038459530854264
5401346338,0.6944858420268256,71,18,43,139,400,671,0.07739647314941635
9639938201,0.7221350078492935,32,9,50,121,425,637,0.07638776111682516
1011516795,0.9143426294820717,11,7,33,101,350,502,0.07615714055322936
1780689197,0.5344418052256532,161,14,87,178,402,842,0.07478446050134079
0582729244,0.6627393225331369,67,21,78,178,335,679,0.07474171603447172
7466620523,0.7603448275862069,50,4,18,96,412,580,0.07320994675076255
2878206081,0.811214953271028,22,15,60,116,322,535,0.07202691489146391
3484426709,0.8681541582150102,7,3,61,105,317,493,0.07100844439173247
6206952113,0.42342342342342343,223,47,112,108,509,999,0.07032369701035368
5884395087,0.5842857142857143,91,17,50,145,397,700,0.06793793579400777
3136050621,0.7195767195767195,55,10,26,136,340,567,0.06772627795449718
6314155884,0.6457326892109501,93,12,24,137,355,621,0.06658479670524373
4761413478,0.8851351351351351,20,8,27,91,298,444,0.06517236877056967
8498386461,0.778,34,9,22,69,366,500,0.06454172913543228
2677514294,0.8976744186046511,12,6,40,88,284,430,0.06400210747339509
8593581989,0.6386986301369864,48,16,40,141,339,584,0.061922805720427465
6996765609,0.6078431372549019,84,18,56,88,366,612,0.061766502369730164
9381740104,0.5553892215568862,99,21,53,107,388,668,0.06161739489536668
7438217426,0.5366568914956011,97,37,44,152,352,682,0.06079071900999646
1465121928,0.7510460251046025,36,12,35,139,256,478,0.059553208054271334
5622176481,0.7051792828685259,43,14,63,103,279,502,0.05873557245281742
3945144406,0.8796992481203008,9,7,26,94,263,399,0.0581776780782541
2016364662,0.8009153318077803,25,4,21,112,275,437,0.05803734288462176
7456805088,0.43625,162,36,56,148,398,800,0.05799225387306347
8807521157,0.8663239074550129,12,5,21,99,252,389,0.05584996704732467
1311031514,0.8882978723404256,16,2,22,109,227,376,0.05534289592792257
0526377570,0.83,18,10,33,68,271,400,0.055029152090621355
5515852246,0.8358585858585859,20,4,11,55,306,396,0.05486061682963232
7093148458,0.6832298136645962,38,8,35,123,279,483,0.05474488428663515
6150841367,0.727906976744186,26,15,39,101,249,430,0.05189808196676856
5589672451,0.8,20,6,25,71,268,390,0.05170747959353657
8513515878,0.8638888888888889,13,2,16,73,256,360,0.05151961056508783
6482683709,0.775,26,8,19,49,298,400,0.05138264201232717
2182761528,0.7368421052631579,29,8,20,91,270,418,0.05106218820414354
5855478893,0.85,9,12,30,92,217,360,0.05069132100616358
9967131222,0.5948616600790514,68,20,40,121,257,506,0.04994340774276893
7144667296,0.3389830508474576,188,49,87,134,427,885,0.0498620746124113
6040129711,0.592,72,19,31,113,265,500,0.049111444277861065
2310523629,0.7851458885941645,18,5,16,88,250,377,0.049047094489890336
5561014837,0.5748031496062992,104,8,20,77,299,508,0.04845084019669955
1979186822,0.6165254237288136,70,22,46,94,240,472,0.048270356347250104
9096094733,0.6889952153110048,45,15,29,96,233,418,0.047746461697380976
3058619333,0.6721311475409836,38,9,33,107,240,427,0.04758549686905181
6377069504,0.42660550458715596,139,45,87,100,283,654,0.04633463084971275
3233848980,0.6441860465116279,53,8,21,116,232,430,0.04592897349774726
5591000048,0.5986984815618221,66,15,28,75,277,461,0.045777545066945924
8133441851,0.7425474254742548,26,6,19,90,228,369,0.045396452631859326
3393079884,0.7679083094555874,26,6,38,82,197,349,0.044388502978692124
5675967901,0.5849889624724062,58,13,44,110,228,453,0.04394969549809348
2909764884,0.7614942528735632,26,8,23,64,227,348,0.043890889804140076
6229978324,0.655,46,16,39,75,224,400,0.04342662002332168
7983597878,0.547568710359408,64,33,59,98,219,473,0.042962662431997534
3944722282,0.6379310344827587,41,16,30,98,221,406,0.04293255671015067
8374237747,0.7626112759643917,24,9,17,79,208,337,0.042557850649353864
7258066216,0.8614864864864865,20,4,14,72,186,296,0.042191741966854414
2093266070,0.6435897435897436,44,15,29,115,187,390,0.04159800441659513
8843756132,0.7296511627906976,25,8,20,80,211,344,0.04156933161326313
2724278264,0.8333333333333334,12,7,19,63,199,300,0.041368204786495645
8085004717,0.8266666666666667,15,5,29,79,172,300,0.04103725914820368
8039823060,0.8233333333333334,25,1,6,19,249,300,0.0408717863290577
7826860915,0.8065573770491803,14,3,11,75,202,305,0.04071079214491115
5036880014,0.8448275862068966,13,5,27,58,187,290,0.04053145840872667
7329875107,0.8133333333333334,15,10,16,48,211,300,0.04037536787161975
8511140287,0.585956416464891,48,21,51,81,212,413,0.04011795555007001
4403789465,0.8175675675675675,17,5,21,68,185,296,0.04004079041560301
5299663243,0.8033333333333333,17,4,21,65,193,300,0.039878949414181804
1745407609,0.8310344827586207,6,4,39,80,161,290,0.03986972031225766
3055641494,0.7866666666666666,20,5,33,51,191,300,0.03905158531845188
5011759824,0.8472727272727273,13,7,32,70,153,275,0.038531643269274454
7323876477,0.5948717948717949,41,27,23,97,202,390,0.03844915149262975
6031312383,0.6270270270270271,33,21,50,82,184,370,0.03843843843843844
7308983032,0.5615763546798029,57,23,38,94,194,406,0.03779391092631024
0873944256,0.3929824561403509,118,33,73,110,236,570,0.037183747307632735
8373815586,0.36666666666666664,162,28,31,107,272,600,0.036526181353767555
7172021344,0.754325259515571,27,8,35,52,167,289,0.03606385965033631
3157699461,0.7003257328990228,38,9,24,55,181,307,0.0355821003721809
8383327046,0.6815286624203821,29,11,22,45,207,314,0.03542177955608183
1469277014,0.8473895582329317,10,2,7,21,209,249,0.034866770095541254
8553125908,0.7,32,11,29,51,177,300,0.03474929202065634
7064700245,0.8936170212765957,8,3,11,48,165,235,0.03468478526694099
7678011763,0.39433962264150946,111,28,69,92,230,530,0.034684544520192734
7939504322,0.5897435897435898,50,9,39,65,188,351,0.034286275665586015
2937961880,0.69,25,12,40,68,155,300,0.03425287356321839
1993005163,0.828,4,0,18,50,178,250,0.03420689655172413
9165178667,0.68,37,11,15,77,160,300,0.033756455105780445
8632261124,0.85,10,6,6,56,162,240,0.033699816758287524
8589853017,0.3794392523364486,117,28,61,82,247,535,0.03369000857826538
8388948086,0.4879807692307692,56,32,50,103,175,416,0.03365384615384615
9407826356,0.47754137115839246,66,27,21,135,174,423,0.033490740839194275
5317931936,0.67,32,9,18,70,171,300,0.0332600366483425
9626848441,0.8403361344537815,10,4,12,50,162,238,0.033036702937046886
2227611225,0.7786561264822134,11,9,28,65,140,253,0.032557502539902645
2458461686,0.98,1,1,2,16,180,200,0.032323838080959524
2859237157,0.7384615384615385,24,6,23,45,162,260,0.03173797716526352
6771334877,0.3804780876494024,135,18,28,62,259,502,0.0316906619731303
4349905478,0.6725352112676056,34,7,26,72,145,284,0.03159335825045224
9919625955,0.8008474576271186,16,2,33,55,130,236,0.031217442126394428
5761693532,0.3900414937759336,114,28,58,90,192,482,0.03118772563925506
2769355292,0.5529411764705883,66,4,10,48,212,340,0.03113345288140244
4357085477,0.7800829875518672,12,1,17,65,146,241,0.031057776782424832
3048961177,0.8703703703703703,6,0,10,44,156,216,0.031027696028528947
5178179359,0.935,2,2,6,23,167,200,0.030839580209895055
3207771633,0.6902985074626866,19,10,13,68,158,268,0.030587939860915316
5730710288,0.8409090909090909,19,4,14,43,140,220,0.03053776142231914
3210813342,0.925,3,4,9,35,149,200,0.030509745127436285
4930149915,0.91,4,2,8,47,139,200,0.030014992503748127
8437248576,0.6617100371747212,29,14,34,57,135,269,0.029431380963793198
8730149570,0.5636942675159236,31,23,26,76,158,314,0.029297453184235905
4054114789,0.7213114754098361,10,10,6,44,174,244,0.02907835699636521
6279894587,0.7489361702127659,14,11,28,46,136,235,0.029069153366579118
6472288104,0.46174142480211083,77,17,22,70,193,379,0.02899825373153353
9170005821,0.6205673758865248,51,9,18,55,149,282,0.02894533820560169
4039787195,0.6444444444444445,42,9,25,54,140,270,0.028770799785292542
9049487430,0.87,7,2,13,38,140,200,0.028695652173913046
5256358403,0.87,7,2,13,38,140,200,0.028695652173913046
9085198515,0.5844594594594594,41,10,33,76,136,296,0.02862420141280711
4346473389,0.6431226765799256,29,14,34,57,135,269,0.02860465677941698
7629625918,0.865,13,0,14,29,144,200,0.02853073463268366
1443105618,0.8693467336683417,5,6,9,33,146,199,0.02852928644555444
3287710992,0.7413793103448276,20,5,25,41,141,232,0.028405337561104506
0302380075,0.6286764705882353,39,8,7,35,183,272,0.02827630302495811
7903373491,0.6356877323420075,29,14,34,57,135,269,0.0282739671056665
2685159255,0.6653696498054474,22,1,16,59,159,257,0.028264078077692673
4924809850,0.855,10,4,13,42,131,200,0.028200899550224888
6314291662,0.5666666666666667,30,20,24,73,153,300,0.028130379254817036
8064699597,0.85,4,3,23,38,132,200,0.028035982008995503
8587479257,0.83,13,6,7,45,129,200,0.02737631184407796
8140561325,0.5466666666666666,31,22,24,73,150,300,0.027137542339941142
7622053240,0.7068965517241379,25,6,15,61,125,232,0.02708415906989034
6623963574,0.8817204301075269,4,5,21,28,128,186,0.027025913566514233
6284894632,0.5955882352941176,36,8,20,52,156,272,0.026788076549960314
4570391598,0.9470588235294117,1,3,7,41,118,170,0.026504394861392833
4394381737,0.8,12,3,11,27,147,200,0.026386806596701652
8573017194,0.785,23,1,6,37,133,200,0.025892053973013494
1888209743,0.785,10,4,11,31,144,200,0.025892053973013494
9616975882,0.78,9,2,10,49,130,200,0.02572713643178411
2764859252,0.5344827586206896,43,15,13,47,172,290,0.025642351238174012
8538630230,0.775,14,4,13,35,134,200,0.025562218890554725
7490303916,0.77,12,4,8,46,130,200,0.02539730134932534
9421405743,0.5503597122302158,56,7,11,46,158,278,0.02530389481518234
2658970915,0.6909090909090909,14,14,15,49,128,220,0.025090485060500052
6110379877,0.5033333333333333,33,15,15,44,193,300,0.024986395691043366
3985946917,0.755,11,4,17,48,120,200,0.024902548725637182
7674259915,0.75,8,6,10,38,138,200,0.024737631184407798
6238528976,0.6952380952380952,18,10,25,42,115,210,0.02408954253032214
6038325771,0.8248587570621468,9,1,8,24,135,177,0.02404635723569477
2709798689,0.46325878594249204,56,11,18,46,182,313,0.024000246947878567
4075622794,0.72,20,4,15,39,122,200,0.023748125937031486
2813129719,0.72,17,12,20,49,102,200,0.023748125937031486
1355954531,0.7222222222222222,20,4,24,50,100,198,0.023580802191496844
3107609589,0.7121212121212122,16,7,13,57,105,198,0.023251000762245143
2324574927,0.7,20,8,15,44,113,200,0.023088455772113943
3542820423,0.46,65,10,29,51,145,300,0.022835249042145598
7088304169,0.69,16,12,23,51,98,200,0.022758620689655173
4159194776,0.6884422110552764,19,9,27,45,99,199,0.02259255631815583
1578351052,0.37815126050420167,79,21,29,72,156,357,0.022362768195734063
8402612135,0.5152671755725191,41,5,21,58,137,262,0.02231708573194319
8085738168,0.675,17,6,21,39,117,200,0.02226386806596702
2672796153,0.5056603773584906,40,9,17,47,152,265,0.022153703022702486
7096823929,0.8580645161290322,3,1,12,26,113,155,0.021869710306137255
7939485914,0.7415730337078652,20,4,7,43,104,178,0.02174193801975417
3942715813,0.8148148148148148,10,2,8,29,113,162,0.021717536293581603
7107853753,0.868421052631579,4,3,11,37,97,152,0.021699676477550698
3426831090,0.655,27,6,23,35,109,200,0.021604197901049477
0497169286,0.6649746192893401,22,4,15,28,128,197,0.021600874689558774
6004856009,0.7081081081081081,24,4,19,33,105,185,0.021586504045274662
6688342318,0.43333333333333335,66,9,15,43,167,300,0.021511466488977737
3445348395,0.52,39,10,18,47,136,250,0.021482592037314677
8265239832,0.65,23,9,22,36,110,200,0.021439280359820092
6340390364,0.645,34,4,6,34,122,200,0.021274362818590707
7452441469,0.645,26,5,18,33,118,200,0.021274362818590707
4546119659,0.6789473684210526,14,5,17,37,117,190,0.02126305268418422
5873547407,0.7413793103448276,18,0,18,57,81,174,0.02124225243699989
9552945768,0.9626865671641791,0,1,4,17,112,134,0.02116852021750319
7255695750,0.735632183908046,23,2,15,27,107,174,0.021077583813457257
8304108977,0.7470588235294118,7,9,8,32,114,170,0.020907193462092483
5061959149,0.6237623762376238,22,6,30,47,97,202,0.020781688363738924
0170614202,0.63,22,4,18,27,129,200,0.02077961019490255
6996116155,0.48828125,50,9,25,36,136,256,0.020660242795269033
8094001427,0.78125,9,8,22,42,79,160,0.02056263534899217
8202210651,0.8802816901408451,3,2,14,31,92,142,0.020529641282645065
3999078893,0.62,33,7,19,31,110,200,0.02044977511244378
5481177792,0.6739130434782609,15,5,19,48,97,184,0.020431813078967763
1765708794,0.492,47,9,15,49,130,250,0.02032583708145927
5499628429,0.82,4,4,8,34,100,150,0.02021655838747293
7988884741,0.61,24,13,26,41,96,200,0.020119940029985007
3067413593,0.6421052631578947,25,5,7,36,117,190,0.02010924362380213
0593241153,0.7908496732026143,7,1,9,48,88,153,0.019893103557153884
0639112122,0.852112676056338,5,2,9,23,103,142,0.01987269276160042
3199489046,0.6,26,11,13,20,130,200,0.019790104947526237
3573781378,0.6,35,2,20,47,96,200,0.019790104947526237
8677505686,0.8695652173913043,6,3,11,35,83,138,0.019700294780146156
1227378180,0.3730407523510972,71,23,40,39,146,319,0.019699136847459237
2388280398,0.8040540540540541,13,2,5,20,108,148,0.019555537546542046
4094312356,0.6742857142857143,24,5,19,26,101,175,0.019432188667570977
4144191075,0.585,29,5,24,53,89,200,0.01929535232383808
2975369038,0.6802325581395349,24,6,24,39,79,172,0.01926362400195251
8802066445,0.5132743362831859,30,20,30,50,96,226,0.019152665555128044
3769677551,0.575,28,6,21,38,107,200,0.01896551724137931
0198580325,0.4956521739130435,32,9,16,29,144,230,0.01882536992373379
1735522859,0.7916666666666666,9,2,10,34,89,144,0.01872674773724249
6672498064,0.5628140703517588,30,7,11,31,120,199,0.018469827063017905
5670839678,0.7516778523489933,7,9,14,31,88,149,0.018406903930585045
0423850980,0.9572649572649573,3,1,0,2,111,117,0.018338409143006842
5908947968,0.36666666666666664,77,16,17,65,125,300,0.018202010106058084
8756981822,0.55,25,12,30,37,96,200,0.018140929535232386
3382734479,0.5729166666666666,30,10,25,37,90,192,0.01813329446387917
4950239094,0.6010928961748634,26,8,33,35,81,183,0.018123907081067845
7515962744,0.7482993197278912,8,1,12,44,82,147,0.018074862795359692
6658234213,0.5572916666666666,30,10,25,37,90,192,0.017638750069409737
6165028166,0.7737226277372263,4,1,17,23,92,137,0.017400059094540322
8226071996,0.8833333333333333,3,1,7,28,81,120,0.017363540451996222
3768636774,0.5175879396984925,43,3,31,36,86,199,0.016985644531168253
8300490446,0.7803030303030303,5,5,11,29,82,132,0.01689811659826652
2481700479,0.7923076923076923,10,2,8,19,91,130,0.016894117044042083
5648821282,0.44493392070484583,48,5,13,42,119,227,0.016676683684589425
1606369074,0.6733333333333333,23,3,10,31,83,150,0.016600588594591594
4611695296,0.6578947368421053,15,11,5,43,78,152,0.016439148846629316
7057656508,0.7122302158273381,16,2,9,34,78,139,0.016254462696709198
8829126088,0.49,50,2,18,26,104,200,0.016161919040479762
5048971152,0.5764705882352941,23,9,18,34,86,170,0.01613310991563042
3647979348,0.46190476190476193,33,11,20,38,108,210,0.01600469606466608
9324193182,0.49238578680203043,42,9,15,36,95,197,0.015994540800665657
7875098254,0.8,8,2,4,25,81,120,0.01572547059803432
1574903396,0.96,0,0,7,25,68,100,0.01567216391804098
7791989603,0.96,0,0,1,15,84,100,0.01567216391804098
8783098099,0.96,1,0,3,15,81,100,0.01567216391804098
1158816571,0.475,42,7,25,33,93,200,0.015667166416791604
8112767567,0.5588235294117647,34,4,12,39,81,170,0.01563923920392745
1041468256,0.95,0,0,1,15,84,100,0.015508912210561386
7192457798,0.94,0,1,2,25,72,100,0.015345660503081792
5299358593,0.9690721649484536,0,1,3,28,65,97,0.015335974624371662
1823553727,0.93,2,1,4,11,82,100,0.0151824087956022
3726156094,0.44878048780487806,25,21,67,17,75,205,0.015176151761517615
8573844888,0.46,35,9,29,25,102,200,0.01517241379310345
0090688011,0.7666666666666667,10,1,6,19,84,120,0.015070242656449554
6023437969,0.35546875,60,14,35,54,93,256,0.015040656754955856
7012324733,0.92,2,1,6,17,74,100,0.015019157088122606
2074398203,0.7,14,3,17,19,77,130,0.014925870398134266
4623727109,0.91,1,2,3,11,83,100,0.014855905380643013
3658703788,0.91,0,1,9,30,60,100,0.014855905380643013
2001352937,0.8108108108108109,10,0,4,28,69,111,0.014722368545457002
7381560368,0.9,2,2,6,23,67,100,0.014692653673163419
8749073994,0.9,2,3,7,23,65,100,0.014692653673163419
4792563340,0.9375,0,0,0,18,78,96,0.014680159920039978
5546747968,0.5705128205128205,29,3,14,32,78,156,0.01463584447092693
4859090141,0.6742424242424242,12,4,10,20,86,132,0.014601285215977868
0983837125,0.7946428571428571,8,1,2,12,89,112,0.014561171795054853
4215761265,0.89,2,2,7,20,69,100,0.014529401965683825
1319634714,0.89,7,2,3,18,70,100,0.014529401965683825
9764932731,0.7333333333333333,12,4,5,27,72,120,0.01441501471486479
0080180778,0.3,68,23,32,57,110,290,0.014392803598200898
4630630718,0.88,2,1,8,24,65,100,0.014366150258204232
2947989681,0.88,1,6,13,10,70,100,0.014366150258204232
1607903927,0.88,0,3,11,17,69,100,0.014366150258204232
6660530980,0.5240963855421686,25,14,21,33,73,166,0.014318142133752399
6783597262,0.2654320987654321,86,20,38,45,135,324,0.014237737098528927
4787827050,0.87,2,0,9,22,67,100,0.014202898550724638
0236666978,0.9775280898876404,2,0,6,21,60,89,0.014167073766487542
4526262286,0.7226890756302521,16,1,4,24,74,119,0.01408539427765109
7558604672,0.86,4,0,10,10,76,100,0.014039646843245044
3301340299,0.7870370370370371,7,2,4,28,67,108,0.01389737230150357
8142924287,0.8673469387755102,4,2,2,12,78,98,0.013870615712551887
2729952657,0.42,45,5,22,37,91,200,0.013853073463268367
2358473482,0.7,7,6,6,28,73,120,0.013759786773280026
4060973472,0.7,10,4,8,29,69,120,0.013759786773280026
2586560264,0.7058823529411765,13,4,15,14,73,119,0.013757826968868507
8489208261,0.865979381443299,4,2,5,21,65,97,0.013704487962204465
7021899019,0.6102941176470589,18,4,11,40,63,136,0.013623090415576527
2074102390,0.6974789915966386,13,4,15,14,73,119,0.013594043314477213
4281889657,0.6974789915966386,15,3,6,25,70,119,0.013594043314477213
4601469668,0.83,7,2,2,18,71,100,0.013549891720806263
1026101234,0.5256410256410257,25,8,13,34,76,156,0.013484710636134925
6997060080,0.5324675324675324,24,6,15,29,80,154,0.013482436271041967
8639399450,0.7130434782608696,10,4,13,16,72,115,0.013422274370061348
4265890509,0.82,2,1,12,22,63,100,0.01338664001332667
4536733133,0.82,5,3,8,22,62,100,0.01338664001332667
0848333478,0.82,4,4,4,22,66,100,0.01338664001332667
8155312669,0.4682080924855491,31,16,21,28,77,173,0.013337262004835732
4310535962,0.6532258064516129,15,4,16,24,65,124,0.013275620254388934
4399764457,0.81,4,8,3,16,69,100,0.013223388305847078
8959790731,0.4,52,6,14,38,90,200,0.013193403298350826
2189489591,0.4,52,5,12,36,95,200,0.013193403298350826
8797997734,0.6504065040650406,10,10,10,30,63,123,0.013109976177223042
3814059247,0.8,5,3,15,23,54,100,0.013060136598367484
8539986200,0.8,6,1,6,20,67,100,0.013060136598367484
1103644405,0.8,8,1,6,24,61,100,0.013060136598367484
2394979164,0.395,36,20,33,40,71,200,0.013028485757121441
9148343678,0.898876404494382,0,3,2,15,69,89,0.013027194268034522
3831043962,0.6929824561403509,10,4,11,21,68,114,0.012929207910664552
1784623917,0.7523809523809524,12,1,1,18,73,105,0.012909418306719656
3224958335,0.79,3,1,5,22,69,100,0.01289688489088789
8743236213,0.79,8,1,10,21,60,100,0.01289688489088789
8751334444,0.79,7,1,4,24,64,100,0.01289688489088789
6220239034,0.79,4,2,9,23,62,100,0.01289688489088789
8210210039,0.39,45,12,12,28,103,200,0.012863568215892055
8378051262,0.78,12,1,6,21,60,100,0.012733633183408297
5186437689,0.78,6,4,6,19,65,100,0.012733633183408297
0029936679,0.78,5,2,8,18,67,100,0.012733633183408297
4587867741,0.6311475409836066,15,4,18,19,66,122,0.012616642498422922
7372158647,0.6311475409836066,15,4,18,19,66,122,0.012616642498422922
7505933656,0.77,8,5,5,25,57,100,0.012570381475928703
6862117917,0.77,6,3,16,22,53,100,0.012570381475928703
6777666099,0.77,6,5,7,24,58,100,0.012570381475928703
6809098821,0.4634146341463415,42,2,15,36,69,164,0.012505942150875783
8995555931,0.5846153846153846,11,8,19,33,59,130,0.0124655620907495
7248477928,0.6229508196721312,15,4,18,19,66,122,0.012452789998443403
4703205400,0.76,8,2,3,20,67,100,0.01240712976844911
2303718805,0.7676767676767676,5,2,15,20,57,99,0.012404572124712054
3978493013,0.4934210526315789,24,12,14,30,72,152,0.012329361634971987
5079786486,0.5769230769230769,22,5,11,29,63,130,0.012301541536923845
0124694175,0.75,3,2,15,22,58,100,0.012243878060969516
8404116912,0.75,7,1,7,27,58,100,0.012243878060969516
9564725528,0.75,7,2,7,37,47,100,0.012243878060969516
4819004538,0.75,6,4,7,26,57,100,0.012243878060969516
5632188801,0.8522727272727273,4,0,2,2,80,88,0.012209804188814684
3031019830,0.6788990825688074,14,6,8,21,60,109,0.012100983147569947
6754856457,0.74,8,3,10,25,54,100,0.012080626353489922
8920273336,0.74,11,1,2,12,74,100,0.012080626353489922
1520773861,0.7551020408163265,6,5,10,22,55,98,0.012075594855633406
8928061135,0.8314606741573034,3,1,4,6,75,89,0.012050154697931933
7048002336,0.73,9,4,9,30,48,100,0.011917374646010328
2578512859,0.73,9,5,7,23,56,100,0.011917374646010328
2795379466,0.73,7,2,6,17,68,100,0.011917374646010328
7690380303,0.73,5,10,13,26,46,100,0.011917374646010328
6695864433,0.29508196721311475,58,20,25,51,90,244,0.01189569149851304
9238695806,0.9125,3,0,5,11,61,80,0.011856571714142927
5591156649,0.72,10,0,10,18,62,100,0.011754122938530735
2632416715,0.72,9,4,5,24,58,100,0.011754122938530735
3760103285,0.5298507462686567,16,6,9,15,88,134,0.011650890972424235
4714394855,0.5298507462686567,21,7,14,27,65,134,0.011650890972424235
4144597897,0.71,7,3,6,21,63,100,0.011590871231051141
2677082045,0.71,13,3,7,24,53,100,0.011590871231051141
1337109322,0.71,14,1,7,20,58,100,0.011590871231051141
3711824623,0.5384615384615384,18,7,9,29,67,130,0.01148143876779559
7461114416,0.7,9,4,10,22,55,100,0.011427619523571547
4565078965,0.7,11,3,12,18,56,100,0.011427619523571547
1631464702,0.7,7,6,9,25,53,100,0.011427619523571547
8368101844,0.7,10,6,3,19,62,100,0.011427619523571547
5095936183,0.7,11,3,6,23,57,100,0.011427619523571547
3673587431,0.7865168539325843,5,2,7,16,59,89,0.011398794984530208
3347286578,0.345,41,10,12,35,102,200,0.011379310344827587
9356964510,0.875,3,2,6,15,54,80,0.011369315342328835
5254269044,0.875,0,2,3,13,62,80,0.011369315342328835
1817302660,0.69,12,4,6,26,52,100,0.011264367816091954
9574044420,0.69,10,7,7,18,58,100,0.011264367816091954
7017471835,0.69,11,1,12,12,64,100,0.011264367816091954
9042851616,0.5271317829457365,21,6,18,15,69,129,0.011152046715660259
1089103567,0.6476190476190476,12,2,10,14,67,105,0.011111904365277678
7053202095,0.68,10,1,15,18,56,100,0.011101116108612362
8281361542,0.68,10,7,16,21,46,100,0.011101116108612362
1213733847,0.68,12,2,12,17,57,100,0.011101116108612362
9164107204,0.8,3,1,7,26,48,85,0.011061136098617358
2192940402,0.6633663366336634,9,4,7,23,58,101,0.010940074517196849
4497109178,0.7127659574468085,7,4,8,28,47,94,0.010923616206081356
8783439637,0.8481012658227848,4,1,9,16,49,79,0.01087852698123512
2762594633,0.66,8,4,4,29,55,100,0.010774612693653174
5565923297,0.66,6,6,13,21,54,100,0.010774612693653174
1118957791,0.22108843537414966,77,24,36,46,111,294,0.010754260058179527
3350620022,0.7333333333333333,6,4,14,17,49,90,0.010750180465322895
8584606740,0.7333333333333333,8,1,6,15,60,90,0.010750180465322895
7090655301,0.88,6,1,3,16,49,75,0.010701316008662335
5464327056,0.65,16,1,8,17,58,100,0.01061136098617358
9425409000,0.65,11,7,5,25,52,100,0.01061136098617358
4802175914,0.65,12,5,9,13,61,100,0.01061136098617358
3825814186,0.6632653061224489,11,4,12,12,59,98,0.01060694142724556
7401077541,0.5517241379310345,15,3,20,27,51,116,0.010477519860759276
1873714792,0.5663716814159292,17,4,11,23,58,113,0.01047263978630154
1290084267,0.64,9,3,11,26,51,100,0.010448109278693987
7251346458,0.6057692307692307,17,2,8,17,60,104,0.010292930457847998
5295865884,0.63,12,5,12,27,44,100,0.010284857571214393
7257273972,0.63,6,5,17,21,51,100,0.010284857571214393
2648706179,0.6138613861386139,14,1,7,13,66,101,0.010123651045764247
8882182959,0.7654320987654321,4,3,9,15,50,81,0.010073152724049498
2100327586,0.305,46,20,22,35,77,200,0.010059970014992503
6458220846,0.8732394366197183,1,2,2,14,52,71,0.010037234903674922
6250862624,0.9393939393939394,0,2,4,17,43,66,0.010015194422990526
5851000362,0.49193548387096775,22,7,6,17,72,124,0.00999768932737932
7382633197,0.49193548387096775,25,2,5,29,63,124,0.00999768932737932
2292901325,0.5922330097087378,12,2,9,22,58,103,0.009964273526667086
6099987860,0.61,9,4,16,22,49,100,0.009958354156255206
2797276534,0.15151515151515152,120,24,45,65,142,396,0.009944522688150876
0901917139,0.47619047619047616,22,7,5,30,62,126,0.009836351665437122
0384857369,0.6,12,5,9,20,54,100,0.009795102448775612
1709503296,0.6,13,4,6,21,56,100,0.009795102448775612
4229757764,0.6,13,6,6,26,49,100,0.009795102448775612
5838524786,0.6818181818181818,9,3,8,19,49,88,0.009767843351051747
0655603209,0.8333333333333334,5,2,5,15,45,72,0.009717363540451997
5273072716,0.8955223880597015,1,2,4,16,44,67,0.00969664421520583
1631869416,0.9090909090909091,2,0,1,13,50,66,0.00969212363515212
8748395544,0.5042735042735043,19,2,10,20,66,117,0.009660411959262533
6375415960,0.59,12,6,11,19,52,100,0.009631850741296018
3562260977,0.59,13,5,7,20,55,100,0.009631850741296018
9103597191,0.59,12,6,9,26,47,100,0.009631850741296018
6272400831,0.59,12,2,11,19,56,100,0.009631850741296018
9549006079,0.59,11,5,17,16,51,100,0.009631850741296018
1005658949,0.8309859154929577,2,1,4,9,55,71,0.009551562247045491
2402365227,0.6304347826086957,9,4,11,19,49,92,0.00945179584120983
5571086987,0.6823529411764706,9,1,10,17,48,85,0.009434498437055981
4930393574,0.57,10,5,12,24,49,100,0.009305347326336831
6448593687,0.57,21,2,5,27,45,100,0.009305347326336831
7558031468,0.57,17,3,7,11,62,100,0.009305347326336831
2732781146,0.59375,14,4,9,30,39,96,0.00929743461602532
7840280936,0.6627906976744186,6,6,9,13,52,86,0.009274432551166277
6737777036,0.7808219178082192,5,1,5,12,50,73,0.009235108473160681
8861510573,0.8142857142857143,2,0,14,17,37,70,0.009223959448847005
4494248309,0.5894736842105263,14,3,11,25,42,95,0.009132275967279517
3374826202,0.7088607594936709,6,6,7,15,45,79,0.0090925001634204
4994230127,0.4074074074074074,41,6,12,14,62,135,0.009026351022019855
5923559816,0.4435483870967742,23,7,18,30,46,124,0.009014310049276436
6538241029,0.5,18,9,8,18,57,110,0.008995502248875561
3311738668,0.55,14,6,12,19,49,100,0.008978843911377645
6061906396,0.55,20,4,11,23,42,100,0.008978843911377645
1415979647,0.5729166666666666,13,3,11,16,53,96,0.008971208840024432
9100418265,0.6179775280898876,5,10,12,17,45,89,0.008956196059273733
7945050292,0.6179775280898876,7,4,8,21,49,89,0.008956196059273733
5633406961,0.6547619047619048,9,4,14,18,39,84,0.008943940728048674
8052205657,0.22784810126582278,79,8,21,40,89,237,0.008919590837492646
6296248176,0.27,65,8,28,16,83,200,0.008905547226386808
2675344778,0.27,65,11,17,23,84,200,0.008905547226386808
4241926885,0.54,24,2,3,17,54,100,0.008815592203898052
2099952145,0.6,8,4,9,12,57,90,0.00879560219890055
3912995349,0.6067415730337079,5,10,12,17,45,89,0.008793356130923304
2627934942,0.265,42,19,35,33,71,200,0.008740629685157422
8080517332,0.5196078431372549,15,7,5,5,70,102,0.008655802817545476
5133216243,0.53,13,9,13,18,47,100,0.008652340496418458
5023602348,0.5408163265306123,22,1,4,5,66,98,0.008648736856061765
8861963724,0.5408163265306123,16,3,4,14,61,98,0.008648736856061765
3170795799,0.654320987654321,6,1,6,19,49,81,0.008610920877010054
2438874822,0.7794117647058824,5,2,5,23,33,68,0.008569244789370021
3740506271,0.8688524590163934,4,0,0,19,38,61,0.008539446123932568
7490333301,0.37681159420289856,38,5,10,20,65,138,0.008536794404730002
5348597872,0.43333333333333335,23,9,10,22,56,120,0.008517963240601922
8891510160,0.52,15,8,10,17,50,100,0.008489088788938864
5119839563,0.52,12,8,10,21,49,100,0.008489088788938864
8552647113,0.5360824742268041,13,2,15,15,52,97,0.00848373064326943
9607268906,0.5473684210526316,14,5,10,23,43,95,0.008479970541045267
3063891521,0.16451612903225807,90,23,38,46,113,310,0.008440940819912625
2577588397,0.255,55,13,18,36,78,200,0.00841079460269865
3968576123,0.51,23,2,8,20,47,100,0.00832583708145927
2499357251,0.51,21,3,3,20,53,100,0.00832583708145927
7972238873,0.5666666666666667,10,2,14,19,45,90,0.008306957632294963
6278599050,0.7083333333333334,6,5,7,11,43,72,0.008259759009384197
9109506275,0.7083333333333334,5,2,4,16,45,72,0.008259759009384197
9432069822,0.75,5,2,6,17,38,68,0.008245877061469266
8700965291,0.5102040816326531,19,1,11,17,50,98,0.008159185713265816
2724879759,0.6097560975609756,13,0,3,25,41,82,0.008126018291667175
3792351046,0.16333333333333333,105,17,36,39,103,300,0.008108168138153146
6249559287,0.16333333333333333,86,26,49,45,94,300,0.008108168138153146
4950177289,0.3798449612403101,39,5,4,18,63,129,0.008036033662755186
0523125747,0.8928571428571429,4,0,2,13,37,56,0.008031698436496038
6544592756,0.8166666666666667,1,1,6,13,39,60,0.007890499194847021
2779326680,0.48,17,6,11,12,54,100,0.00783608195902049
6443223167,0.48,22,4,9,15,50,100,0.00783608195902049
5699506881,0.3560606060606061,35,8,12,23,54,132,0.007710791069111909
0701890111,0.47,18,9,14,19,40,100,0.007672830251540896
3293509242,0.746031746031746,4,1,3,16,39,63,0.007580865651830169
9185860088,0.746031746031746,4,1,3,16,39,63,0.007580865651830169
6480842298,0.2569832402234637,50,11,20,20,78,179,0.007577216978103127
8285647905,0.46,15,8,14,20,43,100,0.007509578544061303
5225824298,0.46,20,4,5,29,42,100,0.007509578544061303
1516228734,0.46,18,3,24,22,33,100,0.007509578544061303
2411637787,0.5609756097560976,14,2,14,20,32,82,0.007475936828333802
0963385594,0.45,10,4,11,16,59,100,0.0073463268365817095
1929301866,0.9583333333333334,0,0,3,14,31,48,0.007343550446998723
5643800418,0.47368421052631576,22,2,9,15,47,95,0.007338436045135326
2128140960,0.44,24,1,10,14,51,100,0.007183075129102116
7521563920,1.0,0,0,1,11,33,45,0.007163085124104614
8500968343,0.7457627118644068,3,1,6,15,34,59,0.0070812051601317995
0807496127,0.7719298245614035,4,0,4,15,34,57,0.007072487148238746
1781337768,0.8,3,1,5,13,33,55,0.0070631350991171085
7536703696,0.88,5,0,2,13,30,50,0.00703648175912044
6711609923,0.9361702127659575,0,1,4,13,29,47,0.007017767711888737
5388535047,0.9361702127659575,0,1,4,13,29,47,0.007017767711888737
1101308456,0.6142857142857143,8,2,2,9,49,70,0.006958425549130197
1195472912,0.7166666666666667,7,2,4,11,36,60,0.006924315619967794
4320585090,0.7413793103448276,6,0,6,19,27,58,0.006916082188790662
2256391836,0.47191011235955055,11,6,16,18,38,89,0.006839276990718124
6823512000,0.525,14,3,9,17,37,80,0.006821589205397301
2137007161,0.1889400921658986,59,14,24,31,89,217,0.0067669698177025145
1433727155,0.7,7,3,3,8,39,60,0.006763285024154589
6171472825,0.7777777777777778,3,0,1,16,34,54,0.006737372054713384
1082658880,0.9130434782608695,1,1,5,14,25,46,0.0066923060209025925
3955911837,0.5857142857142857,14,0,5,16,35,70,0.006634777849170653
8912619545,0.6307692307692307,10,4,5,11,35,65,0.006619767039557144
4018252634,0.7454545454545455,5,0,5,9,36,55,0.006581557705995488
9517547917,0.82,2,1,5,12,30,50,0.006556721639180409
6635042278,0.8723404255319149,2,0,4,4,37,47,0.006539283549714505
8828138864,0.4,21,7,12,17,43,100,0.006530068299183742
2803583678,0.4,21,9,5,19,46,100,0.006530068299183742
3916156197,0.4,23,6,11,13,47,100,0.006530068299183742
7920871277,0.9534883720930233,0,0,5,10,28,43,0.006512247752092946
7969305928,0.46511627906976744,20,4,13,19,30,86,0.006508373720116686
0571811050,0.547945205479452,8,6,10,16,33,73,0.006480777875902232
5270672702,0.13,92,28,37,40,103,300,0.006453439946693321
7530427494,0.7272727272727273,5,1,5,13,31,55,0.00642103190828828
8172612086,0.39,24,6,8,18,44,100,0.006366816591704148
3822824172,0.5909090909090909,12,3,9,11,31,66,0.006299880362848879
7882852819,0.6190476190476191,5,4,8,15,31,63,0.006290505540880354
6632463121,0.78,4,2,3,12,29,50,0.00623688155922039
7603925789,0.8125,2,1,6,11,28,48,0.006226053639846743
1612521271,0.6551724137931034,7,3,7,17,24,58,0.006111886585442911
3307405468,0.2642857142857143,38,14,17,21,50,140,0.006075533661740558
5729248955,0.7916666666666666,3,0,3,10,32,48,0.006066411238825032
0560983515,0.37,22,8,15,16,39,100,0.006040313176744961
5496637489,0.37,17,4,18,12,49,100,0.006040313176744961
9948870792,0.37,25,5,6,19,45,100,0.006040313176744961
0842237803,0.43023255813953487,14,7,14,24,27,86,0.006020245691107934
7060794924,0.95,0,0,3,7,30,40,0.006013659836748292
4669807240,1.0,0,0,1,7,30,38,0.005997001499250375
5227226542,0.6727272727272727,4,5,7,16,23,55,0.00593945451516666
3926478258,0.3956043956043956,22,2,14,18,35,91,0.005865199268497619
4728719679,0.5142857142857142,10,4,7,20,29,70,0.005825658599271792
5838377750,0.24475524475524477,45,11,23,18,46,143,0.005748873814840832
4283330306,0.8181818181818182,5,0,5,7,27,44,0.005724410522011722
9468128053,0.8780487804878049,1,1,6,8,25,41,0.005704464840750356
5545666774,0.9,0,1,4,9,26,40,0.005697151424287856
9654572407,0.5303030303030303,12,0,18,6,30,66,0.005653738787172071
8070689782,0.20359281437125748,57,10,8,22,70,167,0.005596004393013074
3465033044,0.34,22,10,10,25,33,100,0.005550558054306181
4431797899,0.8536585365853658,3,1,3,2,32,41,0.005546007484062846
4223784295,0.37362637362637363,22,2,14,18,35,91,0.005539354864692196
1135081928,0.53125,12,3,5,12,32,64,0.005486839913376645
3208722878,0.6538461538461539,5,3,3,19,22,52,0.005445994951242328
1017414764,0.165,72,8,23,27,70,200,0.005442278860569715
3779258346,0.68,4,4,4,8,30,50,0.00543728135932034
6796918681,1.0,0,0,1,7,26,34,0.005330667999333667
4604745080,0.5892857142857143,9,2,6,13,26,56,0.005300920968087384
5429823111,0.673469387755102,7,0,5,10,27,49,0.0052728737671980325
5131969407,0.868421052631579,1,1,1,7,28,38,0.005207922354612168
2801173770,0.8918918918918919,1,0,2,14,20,37,0.005200102651377015
1284031298,0.9428571428571428,1,0,0,5,29,35,0.00518312272435211
6957178845,0.9428571428571428,1,0,0,5,29,35,0.00518312272435211
3551425320,0.9428571428571428,1,0,0,5,29,35,0.00518312272435211
7213904730,0.6153846153846154,9,1,6,11,25,52,0.0051256423070516035
7285060611,0.64,6,2,8,12,22,50,0.00511744127936032
1498128970,0.7111111111111111,4,2,4,15,20,45,0.005093749421585503
7803178824,0.7272727272727273,4,0,1,9,30,44,0.005088364908454864
8473590826,0.7619047619047619,1,2,6,5,28,42,0.005076826666032063
2928221900,0.9142857142857143,1,0,0,5,29,35,0.005026058399371742
9353696642,0.5961538461538461,8,1,4,10,29,52,0.00496546598495624
7948559191,0.6078431372549019,6,3,7,10,25,51,0.004961571501830784
9597027845,0.6326530612244898,7,1,10,8,23,49,0.0049533056600951225
2423611694,0.25,32,15,13,25,35,120,0.004914209561885724
3746076137,0.3,23,8,12,18,39,100,0.004897551224387806
4991218866,0.8378378378378378,2,0,4,10,21,37,0.004884944914929922
9660486173,0.5357142857142857,9,4,7,11,25,56,0.004819019061897622
6355713827,0.6,4,4,6,11,25,50,0.0047976011994002995
6630317876,0.6818181818181818,5,0,4,10,25,44,0.004770342101676434
6174393373,0.29,23,8,16,12,41,100,0.004734299516908212
5386763981,0.3625,18,6,5,12,39,80,0.004710144927536231
8978290623,0.9375,0,0,0,6,26,32,0.0046851574212893555
8678748660,0.9375,0,0,0,6,26,32,0.0046851574212893555
5286540379,0.47540983606557374,7,8,3,11,32,61,0.004672527124415934
3229768198,0.6904761904761905,6,2,3,10,21,42,0.004600874166091558
3563281242,0.8055555555555556,0,2,1,7,26,36,0.004562533548040794
9187091103,0.4745762711864407,13,3,4,11,28,59,0.004506221465538418
7606207396,1.0,0,0,0,3,26,29,0.004497751124437781
6449615264,0.5957446808510638,9,1,2,7,28,47,0.004465852180292832
8645702281,0.27,34,8,3,19,36,100,0.004407796101949026
7827313367,0.27,24,9,13,12,42,100,0.004407796101949026
9611846646,0.2872340425531915,32,4,6,6,46,94,0.004402054292002935
5081255273,0.8484848484848485,1,0,4,10,18,33,0.0043816475600583545
8290444395,0.4426229508196721,13,1,9,15,23,61,0.004350283874456215
4532176298,1.0,0,0,0,6,22,28,0.004331167749458604
1158393381,1.0,0,1,1,2,24,28,0.004331167749458604
2412985695,0.6428571428571429,5,3,5,15,14,42,0.004283572499464554
5634554655,0.7714285714285715,4,0,3,5,23,35,0.0042407367744699085
3408714796,0.3880597014925373,19,2,7,15,24,67,0.004201879159922526
2896016680,0.9,0,2,4,3,21,30,0.004197901049475263
5174024458,0.4126984126984127,10,7,6,17,23,63,0.0041936703605869015
6144502369,0.6190476190476191,5,1,4,2,30,42,0.004124921666151052
3108345726,0.65,1,2,1,15,21,40,0.004114609361985674
1397744393,0.6842105263157895,2,2,4,6,24,38,0.004103211552118678
5538619905,0.7027027027027027,2,2,6,8,19,37,0.004097050573812194
8099977273,0.7428571428571429,1,2,6,5,21,35,0.004083672449489541
1892365194,0.625,6,1,4,8,21,40,0.003956355155755455
2349386365,0.625,5,2,4,7,22,40,0.003956355155755455
9709821490,0.6944444444444444,3,0,11,6,16,36,0.003933218575897237
8741211713,1.0,0,0,0,12,13,25,0.0038314176245210726
1622697988,0.6,6,0,3,13,18,40,0.003798100949525237
1559527730,0.631578947368421,6,0,3,11,18,38,0.0037875798942633944
6056082307,0.6486486486486487,3,2,3,6,23,37,0.0037818928373651015
2883626252,0.75,2,0,3,9,18,32,0.0037481259370314842
5035047530,0.25555555555555554,28,2,12,13,35,90,0.0037462750106428268
8841900541,0.7741935483870968,2,1,4,7,17,31,0.003740065451145395
4840681621,0.8275862068965517,1,1,2,3,22,29,0.0037222767926381635
7514863687,0.8571428571428571,3,0,1,4,20,28,0.003712429499535946
1938471939,0.38333333333333336,13,3,12,11,21,60,0.003703703703703704
2991377566,0.9230769230769231,0,0,4,8,14,26,0.0036904624610771537
1063875095,0.9230769230769231,0,1,0,1,24,26,0.0036904624610771537
9018310409,0.9230769230769231,1,1,2,3,19,26,0.0036904624610771537
5092795617,1.0,0,0,1,1,22,24,0.003664834249541896
8979105992,0.575,4,2,3,5,26,40,0.003639846743295019
2008698556,0.696969696969697,1,3,4,8,17,33,0.00359921049576222
6998414566,0.22,29,7,16,11,37,100,0.003591537564551058
8759419501,0.22,32,5,11,13,39,100,0.003591537564551058
4527297230,0.7666666666666667,1,0,6,7,16,30,0.003575989782886335
7736462171,0.7666666666666667,1,2,1,8,18,30,0.003575989782886335
7995107106,0.41509433962264153,9,5,6,7,26,53,0.003526538617483711
8401786407,0.9583333333333334,0,1,0,1,22,24,0.0035121328224776505
7920082045,0.5238095238095238,4,5,2,11,20,42,0.0034903183328970438
0809763431,0.6470588235294118,5,1,2,8,18,34,0.003449255764274726
3054582372,0.6875,4,1,5,6,16,32,0.0034357821089455276
9046006946,0.6875,4,0,0,7,21,32,0.0034357821089455276
4724943974,0.7333333333333333,4,0,5,4,17,30,0.0034205119662391024
8352759013,0.35,12,5,2,10,31,60,0.0033816425120772944
1598533348,0.44680851063829785,12,4,2,3,26,47,0.003349389135219624
4316137731,0.5121951219512195,10,1,1,5,24,41,0.003327604490437708
3179900638,0.6176470588235294,2,2,5,4,21,34,0.0032924714113531472
2159220149,0.7,3,1,1,8,17,30,0.0032650341495918706
4071865049,0.7,3,0,2,6,19,30,0.0032650341495918706
4089713351,0.21739130434782608,30,4,2,14,42,92,0.003259239945244769
2368261309,0.75,2,1,4,4,17,28,0.0032483758120939532
0297303144,0.7777777777777778,2,0,1,3,21,27,0.003239121180150666
2223092766,0.28169014084507044,21,6,12,13,19,71,0.0032378177108628786
8170905761,0.875,0,0,4,5,15,24,0.003206729968349159
3844210659,0.9130434782608695,0,1,0,5,17,23,0.0031940551463398733
1279601635,0.9130434782608695,1,0,1,4,17,23,0.0031940551463398733
6834527078,0.5,5,3,4,9,19,40,0.0031650841246043645
1467257578,0.6666666666666666,3,2,2,5,18,30,0.0031095563329446387
3158445619,0.7407407407407407,3,1,1,8,14,27,0.003084877314429205
1594123635,0.7407407407407407,1,2,0,8,16,27,0.003084877314429205
4196586323,0.7692307692307693,1,1,0,7,17,26,0.0030753853842309616
3918205542,0.8333333333333334,0,2,0,2,20,24,0.0030540285412849135
5273415314,0.40425531914893614,6,3,6,9,23,47,0.003030399693770136
7856770377,0.9523809523809523,0,0,0,1,20,21,0.0030143658329565373
5694302098,1.0,1,0,0,4,15,20,0.0029985007496251873
2234778670,0.6333333333333333,4,3,4,3,16,30,0.002954078516297407
6185283531,0.6333333333333333,2,2,4,9,13,30,0.002954078516297407
5853671780,0.2903225806451613,12,6,9,8,27,62,0.0029017749189921174
1979017192,0.7916666666666666,1,1,1,8,13,24,0.0029013271142206676
7135562354,0.8260869565217391,1,0,5,4,13,23,0.0028898594181170287
6819405702,0.34615384615384615,7,6,10,8,21,52,0.0028831737977165267
1178922995,0.34615384615384615,7,6,10,8,21,52,0.0028831737977165267
1331352086,0.95,0,0,1,4,15,20,0.002848575712143928
3005695083,0.6923076923076923,4,0,2,1,19,26,0.002767846845807865
4997321213,0.2361111111111111,14,12,4,14,28,72,0.0027532530031280657
9336864465,0.8181818181818182,1,1,1,5,14,22,0.0027259097723865344
5503864549,0.8571428571428571,0,0,3,7,11,21,0.0027129292496608838
5985135985,0.8571428571428571,1,0,0,3,17,21,0.0027129292496608838
5705490278,0.9473684210526315,0,0,0,5,14,19,0.0026828690917699042
3914085786,0.4857142857142857,5,3,3,7,17,35,0.002670093524666238
6213210503,1.0,0,0,0,5,13,18,0.0026653339996668335
8769379377,0.53125,4,1,4,7,16,32,0.002654922538730635
5660330907,0.5666666666666667,3,3,6,7,11,30,0.002643122883002943
3420324002,0.6071428571428571,2,1,4,2,19,28,0.002629637562171295
9892607992,0.6296296296296297,4,1,2,5,15,27,0.0026221457172648246
6064062679,0.7083333333333334,2,3,1,4,14,24,0.0025959242600921764
9666286913,0.7391304347826086,1,1,3,9,9,23,0.002585663689894183
7621041727,0.8095238095238095,1,1,0,5,14,21,0.002562210958013057
1299092227,0.85,1,1,2,4,12,20,0.002548725637181409
8139677884,0.5714285714285714,4,2,0,4,18,28,0.002474952999690631
2737566163,0.5714285714285714,6,0,2,10,10,28,0.002474952999690631
8553137739,0.075,77,12,15,26,70,200,0.0024737631184407797
6504750048,0.5925925925925926,6,0,1,3,17,27,0.0024679018515433642
8863115998,0.15,35,3,7,12,43,100,0.002448775612193903
1346534997,0.6956521739130435,3,1,3,6,10,23,0.0024335658257827607
6215895200,0.2830188679245283,11,4,5,7,26,53,0.0024044581482843483
2414600493,0.28846153846153844,12,6,4,12,18,52,0.0024026448314304386
3732468250,0.8,0,0,0,4,16,20,0.00239880059970015
8324500609,0.32608695652173914,8,4,4,8,22,46,0.0023901092931794972
7815421805,0.8421052631578947,1,0,3,3,12,19,0.002384772526017693
0808009878,0.8421052631578947,1,1,2,3,12,19,0.002384772526017693
5397088348,0.36585365853658536,7,6,6,5,17,41,0.0023768603503126484
3982231103,0.40540540540540543,10,3,0,4,20,37,0.0023636830233531884
7522513984,0.4166666666666667,5,3,5,8,15,36,0.002359931145538342
4319588131,0.46875,7,1,2,9,13,32,0.0023425787106446778
3177364022,0.4838709677419355,5,3,5,6,12,31,0.0023375409069658717
9273524995,0.5,5,2,2,5,16,30,0.002332167249708479
5111263083,1.0,0,0,2,6,8,16,0.002332167249708479
6248309461,1.0,0,0,0,1,15,16,0.002332167249708479
2641724891,0.5172413793103449,6,0,2,6,15,29,0.002326422995398852
3673897324,0.5769230769230769,3,2,2,5,14,26,0.002306539038173221
6749260431,0.625,2,2,5,3,12,24,0.0022905214059636848
7848824594,0.15555555555555556,33,8,7,14,28,90,0.0022803413108260684
8866057575,0.6818181818181818,1,0,1,5,15,22,0.0022715914769887782
3008014048,0.6818181818181818,4,0,0,2,16,22,0.0022715914769887782
1459898949,0.75,0,1,1,9,9,20,0.0022488755622188904
8021361375,0.30434782608695654,13,2,2,8,21,46,0.0022307686736341976
9204876483,0.8333333333333334,1,0,1,2,14,18,0.002221111666389028
4134521180,0.9375,0,0,2,3,11,16,0.002186406796601699
7619288400,0.9375,0,0,1,0,15,16,0.002186406796601699
4844231211,0.9375,0,0,0,4,12,16,0.002186406796601699
1014750306,0.9375,0,0,1,3,12,16,0.002186406796601699
0466070722,0.4666666666666667,5,1,2,7,15,30,0.0021766894330612473
5411535437,1.0,0,0,0,5,10,15,0.002165583874729302
9855312632,0.05909090909090909,77,17,25,27,74,220,0.002145896748595399
7316631766,0.5833333333333334,3,0,4,5,12,24,0.0021378199788994394
9019027652,0.6666666666666666,2,1,0,3,15,21,0.0021100560830695763
0232455123,0.7,2,0,5,0,13,20,0.002098950524737631
5638489804,0.7368421052631579,2,0,3,3,11,19,0.002086675960265481
8048717294,0.325,7,3,8,5,17,40,0.002057304680992837
1413082462,0.875,1,1,0,2,12,16,0.0020406463434949193
4215022688,0.875,0,0,1,3,12,16,0.0020406463434949193
7163874810,0.40625,6,2,4,9,11,32,0.0020302348825587207
5955915366,0.41935483870967744,4,1,4,1,21,31,0.002025868786037089
3249417635,0.9333333333333333,0,1,0,1,13,15,0.002021211616414015
9213665968,0.4642857142857143,6,0,3,1,18,28,0.0020108993122486376
7679835003,0.5652173913043478,2,1,0,3,17,23,0.001977272233448493
3578434063,0.5909090909090909,2,2,4,2,12,22,0.001968712613390275
4487571794,0.6190476190476191,2,2,2,1,14,21,0.0019593377914217495
2055106396,0.12,39,3,9,11,38,100,0.0019590204897551224
0443295669,0.65,3,0,3,4,10,20,0.0019490254872563718
3735159993,0.17142857142857143,29,2,3,5,31,70,0.0019418861997572642
9081093925,0.7647058823529411,1,0,1,3,12,17,0.0019108093012317371
8554826945,0.7647058823529411,1,2,0,2,12,17,0.0019108093012317371
3841781132,0.8125,0,0,1,3,12,16,0.0018948858903881393
3234732060,0.8666666666666667,1,0,0,3,11,15,0.0018768393580987286
5434190353,0.5454545454545454,3,2,0,2,15,22,0.0018172731815910225
2499593677,0.6,1,1,3,1,14,20,0.0017991004497751122
3161138905,0.75,2,0,0,4,10,16,0.0017491254372813594
3480654843,0.8571428571428571,1,0,0,2,11,14,0.0017134289997858213
9158590270,0.4583333333333333,4,2,2,3,13,24,0.0016797156977067021
6067210686,1.0,0,0,0,2,10,12,0.0016658337497917708
4067371970,0.01141552511415525,323,81,94,91,287,876,0.0016620304763904196
2874149963,0.18518518518518517,11,6,10,5,22,54,0.0016041362035031867
2093610696,0.7857142857142857,1,0,3,3,7,14,0.0015706432498036695
2320127453,0.8461538461538461,1,0,0,2,10,13,0.0015505067978831097
9227396158,0.9166666666666666,0,1,0,5,6,12,0.0015270142706424565
6999129512,0.45454545454545453,4,2,2,3,11,22,0.0015143943179925189
1849777698,1.0,0,0,1,2,8,11,0.0014992503748125937
5663594686,0.09,32,9,8,18,33,100,0.0014692653673163418
4499815643,0.7142857142857143,1,1,0,4,8,14,0.0014278574998215178
3564209309,0.3,12,1,3,4,10,30,0.0013993003498250875
1282219763,0.8333333333333334,1,0,0,2,9,12,0.0013881947914931424
9667186713,0.8333333333333334,1,0,0,4,7,12,0.0013881947914931424
6021039186,0.36,7,1,2,4,11,25,0.001379310344827586
3812420426,0.391304347826087,7,0,1,2,13,23,0.001368880777002803
8672242582,0.47368421052631576,3,1,1,4,10,19,0.0013414345458849521
5492591608,0.47368421052631576,5,0,2,0,12,19,0.0013414345458849521
4416776028,1.0,0,0,0,4,6,10,0.0013326669998334167
4491417747,1.0,0,0,0,1,9,10,0.0013326669998334167
1900774751,1.0,0,0,0,3,7,10,0.0013326669998334167
0905170330,1.0,0,0,0,0,10,10,0.0013326669998334167
7924375920,1.0,0,0,1,1,8,10,0.0013326669998334167
5232341739,1.0,0,0,1,1,8,10,0.0013326669998334167
7341280786,1.0,0,0,0,1,9,10,0.0013326669998334167
9024381449,1.0,0,0,0,2,8,10,0.0013326669998334167
2601605170,1.0,1,0,2,1,6,10,0.0013326669998334167
9758174711,0.5625,2,2,0,5,7,16,0.0013118440779610195
1627539455,0.09090909090909091,27,8,19,8,26,88,0.0013023791134735663
9007074491,0.6,3,0,3,3,6,15,0.0012993503248375812
3354189534,0.6,3,0,0,3,9,15,0.0012993503248375812
7921897716,0.16,16,3,1,10,20,50,0.00127936031984008
5037698163,0.6923076923076923,3,0,1,2,7,13,0.0012685964709952715
7311137937,0.6923076923076923,1,1,0,3,8,13,0.0012685964709952715
1054026378,0.75,1,0,0,2,9,12,0.0012493753123438282
3730666523,0.75,1,1,1,7,2,12,0.0012493753123438282
9035653465,0.27586206896551724,6,3,4,5,11,29,0.0012407589308793877
6784500935,0.8181818181818182,1,0,1,3,6,11,0.0012266593975739403
4561478311,0.8181818181818182,1,0,1,1,8,11,0.0012266593975739403
5987738305,0.8181818181818182,1,0,0,2,8,11,0.0012266593975739403
2779606095,0.9,0,0,2,0,8,10,0.001199400299850075
7490040090,0.9,0,0,0,3,7,10,0.001199400299850075
5339353877,0.9,0,0,0,0,10,10,0.001199400299850075
4598239872,0.9,0,0,0,3,7,10,0.001199400299850075
6014410544,0.9,0,1,2,2,5,10,0.001199400299850075
1742199867,0.9,0,0,1,0,9,10,0.001199400299850075
7055632609,0.4,3,2,1,7,7,20,0.001199400299850075
9142002767,0.9,1,0,0,2,7,10,0.001199400299850075
1274072158,0.4444444444444444,4,0,1,3,10,18,0.0011845928887408148
4027095476,1.0,0,0,0,1,8,9,0.0011660836248542396
5448552219,0.0472972972972973,51,7,10,25,55,148,0.001150325738031885
6144820805,0.0707070707070707,25,11,17,14,32,99,0.0011425263799076891
2394098199,0.5714285714285714,3,0,0,4,7,14,0.0011422859998572142
4315380324,0.5714285714285714,0,0,1,4,9,14,0.0011422859998572142
0295306420,0.11475409836065574,16,9,7,7,22,61,0.0011278513748590186
9103043779,0.1320754716981132,19,2,7,8,17,53,0.0011220804691993624
9839596158,0.7272727272727273,1,0,2,0,8,11,0.0010903639089546136
8091789442,0.8,0,1,2,2,5,10,0.0010661335998667335
9142042653,0.8,0,0,0,1,9,10,0.0010661335998667335
2039731176,0.8,0,0,1,1,8,10,0.0010661335998667335
3878982111,0.8,0,0,0,1,9,10,0.0010661335998667335
7154922748,0.8,1,0,1,2,6,10,0.0010661335998667335
6297897087,0.8,0,0,0,1,9,10,0.0010661335998667335
0100056763,0.8,1,0,1,1,7,10,0.0010661335998667335
2719932362,0.8,0,0,2,2,6,10,0.0010661335998667335
9001968689,0.8,1,0,1,5,3,10,0.0010661335998667335
2704884102,0.8,1,0,1,1,7,10,0.0010661335998667335
3657727503,0.8,1,0,1,1,7,10,0.0010661335998667335
5177141924,0.8,1,0,3,2,4,10,0.0010661335998667335
2634832752,0.8,0,1,1,2,6,10,0.0010661335998667335
3679597695,0.8,0,1,2,2,5,10,0.0010661335998667335
1170916827,0.8,0,0,1,0,9,10,0.0010661335998667335
4152909225,0.8,1,0,2,2,5,10,0.0010661335998667335
9355370424,0.8,1,0,1,3,5,10,0.0010661335998667335
3005888186,0.8,0,0,0,1,9,10,0.0010661335998667335
5990760421,0.8,1,0,0,0,9,10,0.0010661335998667335
9132709354,0.8,0,0,1,4,5,10,0.0010661335998667335
3083213420,0.8,0,2,1,1,6,10,0.0010661335998667335
2536645901,0.8,0,0,3,2,5,10,0.0010661335998667335
5336605593,0.3684210526315789,5,1,1,2,10,19,0.0010433379801327405
6485786547,0.4666666666666667,3,2,1,2,7,15,0.0010106058082070075
8879460629,1.0,0,0,0,1,7,8,0.0009995002498750624
2049370147,0.5,2,1,1,3,7,14,0.0009995002498750624
8056627876,0.5384615384615384,1,0,1,3,8,13,0.0009866861441074335
0362643813,0.1276595744680851,19,1,4,7,16,47,0.000956968324348464
0832281118,0.6363636363636364,2,0,0,2,7,11,0.0009540684203352868
8570582325,0.6363636363636364,2,0,0,0,9,11,0.0009540684203352868
0282494152,0.6363636363636364,2,0,0,4,5,11,0.0009540684203352868
8093489270,0.6363636363636364,2,0,0,1,8,11,0.0009540684203352868
5883987359,0.2,12,3,0,3,12,30,0.0009328668998833917
7650687486,0.7,1,0,1,3,5,10,0.0009328668998833916
1285849737,0.7,1,0,1,4,4,10,0.0009328668998833916
1881856799,0.7,1,0,1,2,6,10,0.0009328668998833916
6210676511,0.7,1,0,0,0,9,10,0.0009328668998833916
7427944779,0.7,1,2,0,3,4,10,0.0009328668998833916
8218836949,0.7,0,1,0,3,6,10,0.0009328668998833916
1799177413,0.7,1,0,2,3,4,10,0.0009328668998833916
1648492180,0.7,1,0,1,1,7,10,0.0009328668998833916
3167048361,0.2222222222222222,6,2,3,2,14,27,0.0009254631943287616
6566625426,0.24,4,3,4,5,9,25,0.0009195402298850574
5919878058,0.3157894736842105,5,1,1,2,10,19,0.0008942896972566347
5720659256,0.42857142857142855,3,1,1,4,5,14,0.0008567144998929107
9863821518,0.46153846153846156,3,0,0,2,8,13,0.0008457309806635145
3057927320,0.6,1,0,1,0,8,10,0.00079960019990005
2746643180,0.6,1,0,1,1,7,10,0.00079960019990005
6535032671,0.6,2,0,0,1,7,10,0.00079960019990005
7401880596,0.6,0,1,0,3,6,10,0.00079960019990005
8053592599,0.6,1,1,0,0,8,10,0.00079960019990005
6479033448,0.6,2,0,1,0,7,10,0.00079960019990005
9132239223,0.6,1,1,1,2,5,10,0.00079960019990005
2996077494,0.23809523809523808,6,1,2,4,8,21,0.0007535914582391343
4901532626,0.25,4,3,2,3,8,20,0.0007496251874062968
6432738073,0.3333333333333333,3,0,2,0,10,15,0.000721861291576434
2329334836,0.3333333333333333,5,0,2,1,7,15,0.000721861291576434
5818671601,0.35714285714285715,1,1,3,5,4,14,0.0007139287499107589
1069669115,0.38461538461538464,1,0,3,5,4,13,0.0007047758172195954
1411036399,0.4166666666666667,2,2,0,2,6,12,0.0006940973957465712
8393209908,0.5,1,1,1,2,5,10,0.0006663334999167084
3449145727,0.5,2,0,1,5,2,10,0.0006663334999167084
1103666707,0.5,2,0,3,1,4,10,0.0006663334999167084
0576659062,0.5,4,2,0,1,3,10,0.0006663334999167084
9639638014,0.14285714285714285,8,4,0,8,8,28,0.0006187382499226577
2236176253,0.23529411764705882,5,1,1,2,8,17,0.0005879413234559191
5654621305,0.2857142857142857,2,1,1,1,9,14,0.0005711429999286071
4438213029,0.2857142857142857,2,2,1,1,8,14,0.0005711429999286071
9705420646,0.36363636363636365,2,1,1,1,6,11,0.0005451819544773068
5174079671,0.4,2,1,0,2,5,10,0.0005330667999333667
2132221620,0.4,2,1,1,2,4,10,0.0005330667999333667
5168718130,0.4,2,2,1,1,4,10,0.0005330667999333667
3715115991,0.4,2,1,1,2,4,10,0.0005330667999333667
2339755747,0.4,2,0,2,2,4,10,0.0005330667999333667
6174410420,0.4,1,0,2,5,2,10,0.0005330667999333667
8157885139,0.4,1,0,2,1,6,10,0.0005330667999333667
4425393145,0.4,3,0,0,2,5,10,0.0005330667999333667
6967651961,1.0,0,0,0,0,5,5,0.0004997501249375312
5359705694,1.0,0,0,0,0,5,5,0.0004997501249375312
8188074237,0.03,36,11,6,13,34,100,0.0004897551224387806
4450204968,0.23076923076923078,4,0,2,1,6,13,0.00042286549033175726
7090167670,0.2727272727272727,4,0,2,2,3,11,0.0004088864658579801
3662459644,0.3,2,1,2,2,3,10,0.000399800099950025
5611773739,0.3,2,0,1,1,6,10,0.000399800099950025
8313307390,0.3,2,1,3,1,3,10,0.000399800099950025
6830871601,0.3,2,1,1,1,5,10,0.000399800099950025
9114120851,0.3,1,2,1,1,5,10,0.000399800099950025
9629360839,0.42857142857142855,0,2,0,0,5,7,0.00035696437495537944
9705400257,1.0,0,0,0,0,4,4,0.0003331667499583542
0387860563,1.0,0,0,0,0,4,4,0.0003331667499583542
1563220416,0.02,41,13,3,14,29,100,0.0003265034149591871
7230894687,0.15384615384615385,2,1,3,2,5,13,0.00028191032688783816
8393479106,0.2,0,3,0,4,3,10,0.00026653339996668337
2593004224,0.2,4,0,1,2,3,10,0.00026653339996668337
7432093508,0.2,3,1,0,2,4,10,0.00026653339996668337
6767231710,0.012195121951219513,31,12,6,7,26,82,0.0001625203658333435
8097121233,0.041666666666666664,12,1,1,2,8,24,0.00015270142706424566
8069275228,0.0625,8,0,2,0,6,16,0.00014576045310677995
8575259530,0.0,7,2,3,2,5,19,0.0
1489136641,0.0,4,1,1,2,2,10,0.0
3459700690,1.0,0,0,0,0,2,2,0.0
2608768112,0.0,5,0,1,1,5,12,0.0
8884110507,0.0,4,1,2,1,2,10,0.0
6890422747,0.0,5,1,0,3,1,10,0.0
5257345077,-0.1,5,1,0,0,4,10,-0.00013326669998334168
7781744077,-0.1,5,0,1,1,3,10,-0.00013326669998334168
8872141055,-0.06666666666666667,6,2,1,2,4,15,-0.0001443722583152868
1553956520,-0.038461538461538464,11,1,2,6,6,26,-0.00015376926921154807
2530948763,-0.2,5,0,0,3,2,10,-0.00026653339996668337
9685998720,-0.2,5,1,1,2,1,10,-0.00026653339996668337
5244379686,-0.2,6,0,1,1,2,10,-0.00026653339996668337
8773895091,-0.1,6,4,2,2,6,20,-0.0002998500749625188
2721812547,-0.07692307692307693,12,1,4,2,7,26,-0.00030753853842309614
3480645435,-0.03225806451612903,40,8,12,11,22,93,-0.0004890028104227456
3819829672,-0.13333333333333333,10,4,2,6,8,30,-0.0006219112665889277
2731991935,-0.03,76,22,37,25,40,200,-0.0009895052473763118
7562667376,-0.4375,7,3,2,2,2,16,-0.0010203231717474596
4892127602,-0.13725490196078433,26,5,3,3,14,51,-0.0011203548552521127
2833596936,-0.09722222222222222,32,2,8,8,22,72,-0.001133692413052733
1461450630,-0.2857142857142857,18,2,1,3,11,35,-0.0015706432498036695
1673626066,-0.55,13,4,2,0,1,20,-0.0016491754122938533
4014117411,-0.13,41,10,12,10,27,100,-0.002122272197234716
2099072112,-0.14705882352941177,51,4,5,5,37,102,-0.002449755514399663
9046625001,-0.12,106,3,6,13,72,200,-0.003958020989505247
6014794895,-0.1368421052631579,88,12,22,12,56,190,-0.0042855765099906185
5906839491,-0.32,63,1,3,10,23,100,-0.005224054639346993
8924051795,-0.33,59,5,8,8,20,100,-0.005387306346826587
